---
abandoned: '（人が）（見）捨てられた, （車・家など）放棄された, 乗り捨てられた'
abominable: 'いとうべき, 忌まわしい, 言語道断な, （人・行為・天気など）実にいやな, 不快な, ひどい'
abortion: '妊娠中絶（手術）, （人工）流産, 堕胎（手術）, （計画行動の）失敗, 挫折（ざせつ）, 未熟児, （器官の）発育不全, 奇形'
abroad: '国外へ, 海外へ （うわさなど）広まって, 広く, あちこちに, 外国に'
acclaim: '（業績質などのために）（人物）を歓呼して迎える, 賞賛する, （人物）を宣伝する, 認める, （人業績に対する）賞賛'
accomplish: '（人が）（仕事目標など）を成し遂げる, 達成する, （旅など）を終える, （年齢など）に達する'
achievement: '業績, 功績, 成果, 偉業, 手柄'
acknowledge: 認める （手紙などを）受け取ったことを知らせる
actually: '実際に, 現に'
administration: '管理, 運営, 経営, 統治, 行政, 施政, 管理者側, 経営者陣, （大学などの）本部, 当局'
afterward: '（比較なし） のちに, あとで, その後, 以後'
aisle: '（スーパーマーケット倉庫などの）通路, （乗り物映画館などの座席間の）通路'
albeit: 'たとえ〜でも, 〜にもかかわらず'
amber: 'こはく, こはく色 《茶色がかった黄色》'
annoy: '（人行動などが）（人など）を （一時的に）悩ます, 困らせる, いらいらさせる, むっとさせる, （人など）を （執拗（しつよう）に）攻撃する, たびたび困らせる, やっかいである, 悩みの種である'
anticipate: '予期する （よい事を）楽しみにして待つ, （悪い事を）取り越し苦労する, （〜することを）予想する （〜を）先読みして手を打つ （相手の）機先を制する, （相手を）出し抜く, （〜を）未然に防ぐ, （収入などを）見越して使う'
apparently: '（確証はないが）たぶん, どうも〜らしい, （実際はさておき）外見上は, 見たところ, どう見ても, （思っていたことと違い）実は'
application: '（書面による）志願, 申請, 応用, 利用, 利用法'
appropriate: '（金・ものなどを）（特定の目的に）当てる, 充当する （公共物などを）専有する, 私用に供する, 着服する, 盗む, （目的に合って）適当な, 適切な, ふさわしい （〜に）適切で, 適切な, ふさわしく'
argue: '（人が）（A（人）と）（Bのことで）論争する, 言い争う, 口論する, （人が） （理由を挙げて）（Aに賛成（反対）の）主張をする, 論を述べる, （人などが） （理由を挙げて）（主張事など）を論じる, 議論する, （人が） （理由を挙げて）〜だと主張する, 論じる, 〜と主張する, （主に英）（人が） （〜するように/〜しないように） （人）を説得する, （事などが）〜を立証する, 〜ということを立証する, と主張する'
argumentation: '立論, 論証, 論争, 討論'
arouse: 刺激する
artifact: '（特に史的価値のある）人工（加工）物, 工芸品 〘武器用具など〙, 遺産, 所産,'
assert: '（正当性など）を断言する, 強く主張する, 明言する, 言い張る, （権力など）を行使する, （人が）自己主張する, 毅然（きぜん）とふるまう, でしゃばる, （思想などが）影響する, 効力を発する'
astonish: '（人を）ひどく驚かす, びっくりさせる, （人を）（〜で）驚かせる, びっくりさせる'
atrocity: '残虐（残酷）さ, 凶悪性, 極悪さ'
awkward: '（瞬間沈黙などが）きまりの悪い, 気まずい, （行動人などが）落ち着かない, （人動作などが）不器用な, ぎこちない, ぶざまな'
banter: '（悪意のない）冗談, からかい, ひやかし'
beg: '（人が）A（許可など）を懇願する, お願いする, 請う'
beside: '〜のそばに, 〜の近くに, 〜に比べると, 〜とは無関係で, （要点など）をはずれて'
birthright: '生得権, （特に長子の）相続権'
bonkers: '精神的に不安定で, ばかな, 熱狂して, いらいらして'
bother: '（人・物事が）（人）を悩ませる, 困らせる, A（人）が〜ということで（〜するときに）困る, A（人）が〜することを苦にする'
brace: '〜に対して覚悟する, 備える'
brew: '（ビールなど）を醸造する, 作る, （茶コーヒーなど）を煎じる, いれる, （悪い状況などが）発生しつつある, 起ころうとしている'
calm: '（人心態度などが）落ち着いた, 冷静な, （社会情勢などが）平穏な'
chick: '（ニワトリの）ひな, ひよこ, （一般に）ひな鳥, （特に魅力的な）若い女（娘）'
churn: 〜を撹乳機でかき回す
circumstance: '事情, 情勢, 境遇, 状況'
cite: '〜を引用する, 引き合いに出す'
coherent: '明瞭, 統一性がある, 首尾一貫した'
coincide: 〜と同時（期）に起こる
collateral: '担保（物件）, 傍系親族, 付随する, 副次（二次）的な, 並行した, 相並ぶ, 見返りの'
completion: '完成, 完了, 終了, 成就, 達成'
component: '（物などを構成する） （構成）要素, 部品, 部分'
concatenation: '連鎖, 連結, （事件などの）つながり, 連続'
concede: '（人が）〜を （事実だと）（しぶしぶ）認める, 承認する'
configuration: 設定
consequence: '（主に悪い）結果, 結末, 成り行き, 影響, 重大性'
consistency: '（言動思想などの）一貫性, 一致, （物質の）かたさ, （液体混合物などの）粘度, 濃度, 滑らかさ'
constancy: '不変（性）, 安定, 忠誠（心）, 忠節, 貞節'
consumption: '（時間エネルギーなどの）消費, 消耗, 使い果たすこと, 肺結核'
contract: '契約, 約定, 請負, 協定'
convince: '（人に）（〜を）確信させる, 納得させる'
cosmos: '（秩序と調和の表われとしての）宇宙, コスモス,'
crass: '鈍感な, 無神経な, はなはだしい, 実にひどい（無知愚かさ無神経など）'
crush: '（人物などが）（物）を押しつぶす, （石など）を（押し）砕く, 粉砕する'
cultivate: '（土地を）耕す, 耕作する,（作物を）栽培する,（魚・カキなどを）養殖する,（細菌を）培養する, 養う'
deadpan: '（顔・人など）（特に冗談を言う時も）無表情な（に）, ポーカーフェースの（で）'
debt: '借金, 借り, 負債, 債務'
declare: '（〜を）宣言する, 布告する, 公表する'
decline: '（ていねいに）辞退する, 断わる, 傾く, 下を向く, （夕日などが）傾く, （地位・勢力などが）衰える, 堕落する, 退歩する, 減退する, （物価などが）下落する, 衰退する'
defeat: '（敵・相手を）破る, 負かす （計画・希望などを）挫折（ざせつ）させる, くつがえす, （人を）くじく'
defer: '（決定支払いなど）を引き延ばす, 延期する, 延びる, ぐずぐずする'
defy: '（年長者・政府・命令などを）ものともしない, 無視する, 侮る, （〜に）（公然と）反抗する, （人に）（〜を）やれるものならやってみろと言う（挑む）, （物事が）（〜に向かって）努力しても至らない, （〜を）受けつけない, に反抗する'
deprecate: '（〜を）非難する, （〜に）反対を唱える, （〜を）軽視する'
desecrate: '〜の神聖を汚す, 〜を冒涜する, （神聖なもの）を邪道に用いる'
deserve: '〜に値する, ふさわしい'
despite: '〜にもかかわらず 悪意, 恨み, 無礼, 無視, 軽蔑する'
destination: '（旅行などの）目的地, 到達地, 行き先, （仕事などの）到達点, （手紙などの）あて先, 届け先, 最終目標, 目的'
devoid: '〖be ～ of A〗（人物などが）A（性質など）を欠いている, 持っていない,'
disclaim: '（責任関与など）を否認（否定）する, （要求など）を拒否する, 〜に対する権利を放棄する,'
discriminate: '（〜と〜とを）区別する, 識別（弁別）する, （〜に対して）分け隔てをする, 差別待遇する （against）, （〜を）えこひいきする （in favor of）,'
disparate: '（物が質や種類において）まったく異なる, 本質的に相違する（要素からなる）, 異種の'
dissident: '（特に政府などに）異議を唱える人, 反体制派の人（活動家）,'
distinct: '別個の, 独特な, （ 〜と） まったく異なった （from）, （物形輪郭などが） （知覚的に）鮮明な, 明瞭（めいりよう）な, 明確な'
distinction: '区別, 相違, 差異, 差別, 分け隔て'
distinguish: '（人が）（複数の人物事）を識別する, （人が）（形音においなど）をはっきりと認める, 感知する'
duplicate: '（物）の複製を作る, 〜を複写する, （既に行ったこと）を（不必要に）繰り返す, 複製, 複写, 写し, そっくり同じもの'
elderly: '年配の, 初老の'
embarrassing: '恥ずかしい, 不愉快に感じさせる, 困惑させるような'
encrypt: '暗号化する, 符号化する'
epistolary: '書簡の, 書簡風の'
epitomize: '〜 （の特徴）を典型的に表す, 縮図的に示す, 〜を摘要する, 要約する, 概括する,'
estimate: '（価値大きさ量など）を （〜と） 見積もる, 概算する, 推定する'
explain: '（人本などが）（B（人）に）A（事）を説明する, （A（人）に）〜ということを（〜かを）説明する, （人が）（人に）（正当化しようと）（事）の釈明（弁明）をする, 〜の理由を説明する'
extract: '（物）を取り除く, 〜を引き抜く, 抜き出す'
facial: '顔の, 顔面の, 顔に用いる, 顔用の, （マッサージクリームなどを用いた）美顔術, 顔の手入れ'
fictitious: '虚偽の, うその, 架空の'
frenzied: 熱狂的な
harbor: '（長期間ひそかに）（悪意疑いなど）を心に抱く, （場所が）（生物）のすみかとなる, 〜をかくまう, 〜に隠れ場所を与える'
indefatigable: '疲れを知らない, 根気のよい, 不屈の'
indubitably: '疑う余地のない, 確かな, 明瞭な'
insane: 'まったくばかばかしい, 無茶な'
irrelevant: '重要でない, 意味をなさない, 的はずれな'
isolate: '（国組織など）を孤立させる, 離す'
leap: '跳ぶ, 急上昇する, 前進'
levitate: （超能力で）空中に浮揚する
malady: '（社会組織の）深刻な問題, 弊害'
monitor: '（状況など）を監視する, 監督する, 観察する, 〜を追跡する, 〜を測定する'
nanny: 子守の女性
nevertheless: 'それでもやはり, にもかかわらず'
notoriety: '悪評, 悪名の高い人'
obsessively: '過度に, 執拗に, とりつかれたように'
overwhelmed: '（強烈な感情出来事が）（人）を呆然（ぼうぜん）とさせる, （人）を圧倒する, 大いに驚かす, 困惑させる, （力で）（相手）を打ち負かす, （徹底的に）やっつける, （地域）を支配する'
persevere: '我慢する, 耐える, 信じ続ける'
privilege: '特典, 光栄, 特権'
punctual: '時間を厳守する, 時間（期限）通りの'
reputation: '評判, 世評, うわさ'
resettle: '（別の場所に）（人）を再び定住させる （in） , 〜に再び植民する'
reward: '（功労善事世話などに対する）ほうび, 報酬, 報奨, 報い'
riddance: 厄介払い
riddle: 'なぞなぞ, 判じ物'
sarcasm: '皮肉（の言葉）, 嫌味, 当てこすり'
skeptical: '疑い深い, 懐疑的な, 宗教を疑う, 無神論の, 懐疑論（主義）の, 懐疑派の,'
smite: '〜を強くたたく, 強打する'
substantial: 'しっかりとした, 相当な'
tendency: '（否定的に） （〜への/〜する） 傾向, 風潮, （人の）性癖, くせ （toward（s）, to/to do）'
theft: '盗み, 窃盗'
vet: '（志願者, 文書, 計画など）を詳しく調べる, 審査する, 獣医, （動物を）診療する, （人・ものを）綿密に調べる, 点検する'
wreck: '（計画好機など）を台無しにする, だめにする, （建物乗り物など）を大破させる, 解体する'
