---
Danish: 'デンマークの, デンマーク人（語）の'
absurdly: '不条理に, ばかげたほど'
accuracy: '正確さ, 的確さ'
acquire: '（知識・学問などを）（努力して）得る, 学ぶ, 習得する （習慣などを）身につける,  （財産・権利などを）取得する, 獲得する,  （目標物などを）（レーダーで）捕らえる, 捕捉（ほそく）する'
admit: '（人・ものが）（人・ものを）入れる, （人に）入ることを許す, を認める'
anticipation: '予想, 予期, 見越し'
apply: '（ものを）（〜に）当てる, 塗る, つける （to, on）,  （資金などを）（ある目的に）当てる, 用いる （to, for）,  （規則・原理などを）（〜に）適用する, 応用する （to）, （心・精力などを）（仕事などに）注ぐ, 傾ける （to）, 申し込む'
appropriate: '（金・ものなどを）（特定の目的に）当てる, 充当する （公共物などを）専有する, 私用に供する, 着服する, 盗む, （目的に合って）適当な, 適切な, ふさわしい （〜に）適切で, 適切な, ふさわしく'
assemble: '（ある目的で）（人を）集める, 集合させる, 召集する, （ものを）集めて整理する, （機械などを）組み立てる'
assessment: '評価, 査定'
astute: 明敏な 機敏な 抜けめのない ずるい
authority: '権威, 権力, 威信, 重み, 職権, 当局'
available: '（すぐに）利用できる, 入手できる, 得られる, 手に入る'
blush: '（〜で）顔を赤らめる, （顔が）（〜で）赤くなる （at, for, with）（〜に）恥じる'
budget reserve: 予算の余裕
conduct: '（道徳上から見た人の）行為, 品行, （〜を）指揮する, （人などを）案内する, （〜の）ガイドを務める, を実施する'
confidentially: '内々（に）, ないしょで, 打ち明けて, 心おきなく, 親しげに'
dean: '（大学の）学部長,  （米大学・中等学校の）学生（生徒）部長,  【英国国教会】 （cathedral の）首席司祭, （大）聖堂参事会長,  （団体・同業者などの）最古参者, 長老'
declare: '（〜を）宣言する, 布告する, 公表する'
dedicate: （生涯を）（〜に）ささげる
defeat: '（敵・相手を）破る, 負かす （計画・希望などを）挫折（ざせつ）させる, くつがえす, （人を）くじく'
delusional: '惑わし, 欺き, 妄想, 思い違い'
devour: 'むさぼり食う, がつがつ食う, 滅ぼす'
diagnosis: 診断
distributional: '配分, 配給, 散布 （of）,  【経済】（富の）分配, 【商業】（商品の）流通 （of）,  （動植物・言語・音素などの）分布（区域, 状態）,  【統計】 分布,  区分, 分類 （of）'
dunce: 'のろま, 覚えの悪い生徒, 劣等生'
elicit: '（事実・情報などを）（〜から）引き出す, （事実・返事・笑い声などを）（〜から）誘い出す（from）'
ensure: '（成功などを）確実にする, 保証する, （地位などを）確保する'
exceed: '（予想などを）超える, 超過する, 勝る'
expenditure: '支出, 消費, 浪費, 経費, 費用'
explanation: '説明, 解釈, 釈明, 弁解'
explicit: '（陳述など）明白な, はっきりした, 明示的な, （本・映画など）露骨な, 率直な'
facilitate: '（事を）容易にする, 楽にする, 促進（助長）する'
fallacy: '誤った考え, 虚偽, 錯誤, 誤った推論に基づく誤り'
favorable: '好意ある, 賛成する, 有利な, 順調な, 好都合の'
forecast: '（天気を）予報する, （未来などを）予想する, 予測する'
generate: '引き起こす, 来たす, 発生させる, 生成する, を生み出す'
habit: '（個人の）癖, 習慣, 〜する傾向'
identify: '見分ける, 見極める, 鑑定する, 証明する, 同一視する, 身元を明らかにする, を特定する'
implementation: '履行, 実行, 実施, 充足'
incorporate: '（〜を）（〜と）合体させる, 合同させる （with）'
inept: '不適当な, 不適切な, 適性のない,（言動など）ばかげた, 不条理な, 間抜けた'
initiative: '手始め, 率先, 独創力, 主導権'
instance: '例, 実例, 事例, 実証'
invest: （資本・金を）投資する
jot: 'わずか, 少し'
lethargy: '無気力, 不活発'
litigate: 訴訟する
ministry: '（英国・日本などの大臣 （minister） が管轄する）省, 内閣, 諸大臣,'
miscalculation: 計算間違い
mitigate: '（苦痛・苛酷さを）やわらげる, 静める, 鎮静する,（刑罰を）軽減する'
neglect: 'を怠る, 無視'
obtain: 'を得る, 手に入れる, 獲得する'
odds: '見込み, 可能性, 確率, 賭け率'
omission: '省略, 遺漏, 脱落'
outcome: '結果, 成果'
overrun: （見積もりなどを）超える
pedagogic: '教育学（的, 上）の'
precaution: '用心, 警戒'
prediction: 予言（予報）すること
premise: '（推理を行なう時の結論の基礎となる）前提, 根拠'
prevalent: '一般に行なわれる, 流行する, はやっている, （+前+（代）名）（〜に）広く行なわれて, いたる所にあって （in, among）'
probability: 'ありそうなこと, 起こりそうなこと, 見込み, 公算'
procedure: '（進行・行動の）手続き, 手順, 順序 （for）, （具体的には 【可算名詞】） 訴訟手続き, 議事手続き,'
properly: '適当に, 適切に, ほどよく  礼儀正しく, きちんと'
prophecy: 予言
pursue: '追跡する, 追う, つきまとう, 遂行する, 続行する, 追求する'
quantity: '量, （ある特定の）分量, 数量'
renovation: 改修
renowned: '有名な, 高名な'
specific: '特定の, 固有の, 明確な'
statistical: 統計上の
sufficient: 'するのに充分な, 足りる'
syllabus: '（授業・講演などの）摘要, 概要, シラバス'
transportation: 輸送
uncertain: '（人が）（〜について）確信が持てなくて, はっきり知ら（わから）ないで'
underperform: '期待されたよりも悪く行う, めったに実行しない'
underweight: '重量不足の（で）, 標準重量未満の（で）, 軽視'
unlikely: 'ありそうもない, 本当らしくない'
utilize: '（〜を）（〜に）利用する, 役立たせる'
venture: '冒険的事業, 投機的企業, ベンチャー 投機, 思わく, やま, （危険を伴う）冒険, 危険を冒して進む'
